1111111111
1000000001
1111111101
1000000001
1000001111
1111100001
1000111101
1000100001
1010101111
1010101001
1010000001
1011111111
1000000$01
1000000001
1111111111